10
"Truck Depot" "Lacey" "Norwalk" "Greenville" "Atlanta" "Richmond" "PalmBay" "JohnsonCity" "Melbourne" "HavredeGrace" 
0 96 87 73 85 78 47 65 48 35 
96 0 27 23 35 28 59 31 72 61 
87 27 0 14 26 19 50 22 63 52 
73 23 14 0 12 5 36 8 49 38 
85 35 26 12 0 17 42 20 55 50 
78 28 19 5 17 0 31 13 44 43 
47 59 50 36 42 31 0 44 13 31 
65 31 22 8 20 13 44 0 48 30 
48 72 63 49 55 44 13 48 0 18 
35 61 52 38 50 43 31 30 18 0 